######################################################################
###|.. . . . . . . . . . . . . .|####|. . . . . . . . . . . . . ..|###
###|.|########|.|#############|.|####|.|#############|.|########|.|###
###|*|########|.|#############|.|####|.|#############|.|########|*|###
###|.|########|.|#############|.|####|.|#############|.|########|.|###
###|.. . . . . . . . . . . . . . .. . . . . . . . . . . . . . . ..|###
###|.|########|.|#######|.|################|.|#######|.|########|.|###
###|.|########|.|#######|.|################|.|#######|.|########|.|###
###|.. . . . . .|#######|. . . .|####|. . . .|#######|.  . . . . .|###
##############|.|#############| |####| |#############|.|##############
     #########|.|#############| |####| |#############|.|###
     #########|.|#######|         G          |#######|.|###
     #########|.|#######| |$$$$$$&&&&$$$$$$| |#######|.|###
##############|.|#######| |$$            $$| |#######|.|##############
#              .          |$$            $$|          .              #
##############|.|#######| |$$            $$| |#######|.|##############
     #########|.|#######| |$$$$$$$$$$$$$$$$| |#######|.|###
     #########|.|#######|                    |#######|.|###
     #########|.|#######| |################| |#######|.|###
##############|.|#######| |################| |#######|.|##############
###|. . . . . . . . .. . . . . .|####|. . . . . . . . .. . . . . .|###
###|.|########|.|#############|.|####|.|#############|.|########|.|###
###|.|########|.|#############|.|####|.|#############|.|########|.|###
###|*. |######|. . . . . . . . .   P  . . .  .  . . . .|######|. *|###
#####|.|######|.|#######|.|#################|.|######|.|######|.|#####
#####|.|######|.|#######|.|#################|.|######|.|######|.|#####
###|. . . . . ..|#######|. . . . |###|. . . . |######|. .  . . . .|###
###|.|#########################|.|###|.|########################|.|###
###|.|#########################|.|###|.|########################|.|###
###|. . . . . . . . . . . . .  . . . . . . .  . . . . . .  . . . .|###
######################################################################